owl:Thing	owl:equivalentClass	sumo:Entity
Activity	owl:equivalentClass	sumo:Process
Game	owl:equivalentClass	sumo:Game
BoardGame	owl:subClassOf	sumo:Game
CardGame	owl:subClassOf	sumo:Game
Sales	owl:subClassOf	sumo:FinancialTransaction
Sport	owl:equivalentClass	sumo:Sport
Athletics	owl:subClassOf	sumo:Sport
TeamSport	owl:equivalentClass	sumo:TeamSport
Agent	owl:equivalentClass	sumo:Agent
Deity	owl:equivalentClass	sumo:Deity
Employer	owl:subClassOf	sumo:Agent	# (employs is a relationship)
Family	owl:equivalentClass	sumo:FamilyGroup
NobleFamily	owl:subClassOf	sumo:FamilyGroup
FictionalCharacter	owl:subClassOf	sumo:Agent
ComicsCharacter	owl:subClassOf	sumo:Agent
AnimangaCharacter	owl:subClassOf	sumo:Agent
DisneyCharacter	owl:subClassOf	sumo:Agent
MythologicalFigure	owl:subClassOf	sumo:Agent
NarutoCharacter	owl:subClassOf	sumo:Agent
SoapCharacter	owl:subClassOf	sumo:Agent
Organisation	owl:equivalentClass	sumo:Organisation
Broadcaster	owl:subClassOf	sumo:Agent	# (these are SocialRole instances in SUMO)
BroadcastNetwork	owl:equivalentClass	sumo:BroadcastNetwork
RadioStation	owl:equivalentClass	sumo:RadioStation
TelevisionStation	owl:equivalentClass	sumo:TelevisionStation
Company	owl:equivalentClass	sumo:Business
Bank	owl:subClassOf	sumo:FinancialCompany
Brewery	owl:subClassOf	sumo:Business
Caterer	owl:subClassOf	sumo:Business
LawFirm	owl:subClassOf	sumo:Business
PublicTransitSystem	owl:subClassOf	sumo:TransportationCompany
Airline	owl:equivalentClass	sumo:Airline
BusCompany	owl:subClassOf	sumo:TransportationCompany
Publisher	owl:equivalentClass	sumo:Publisher
RecordLabel	owl:equivalentClass	sumo:RecordLabel
Winery	owl:subClassOf	sumo:Business
EducationalInstitution	owl:subClassOf	sumo:EducationalOrganization
College	owl:equivalentClass	sumo:College
Library	owl:equivalentClass	sumo:Library
School	owl:equivalentClass	sumo:School
University	owl:equivalentClass	sumo:University
EmployersOrganisation	owl:subClassOf	sumo:Organization
GeopoliticalOrganisation	owl:subClassOf	sumo:Organization
GovernmentAgency	owl:subClassOf	sumo:GovernmentOrganization
GovernmentCabinet	owl:subClassOf	sumo:GovernmentOrganization
Group	owl:equivalentClass	sumo:GroupOfPeople
Band	owl:subClassOf	sumo:MusicalGroup
ComedyGroup	owl:subClassOf	sumo:GroupOfPeople
InternationalOrganisation	owl:subClassOf	sumo:Organization
Legislature	owl:subClassOf	sumo:GovernmentOrganization
MilitaryUnit	owl:equivalentClass	sumo:MilitaryUnit
Non-ProfitOrganisation	owl:subClassOf	sumo:Organization
RecordOffice	owl:subClassOf	sumo:Organization
Parliament	owl:subClassOf	sumo:GovernmentOrganization
PoliticalParty	owl:equivalentClass	sumo:PoliticalParty
ReligiousOrganisation	owl:equivalentClass	sumo:ReligiousOrganization
ClericalOrder	owl:subClassOf	sumo:ReligiousOrganisation
SambaSchool	owl:subClassOf	sumo:EducationalOrganization
SportsClub	owl:equivalentClass	sumo:SportsTeam
HockeyClub	owl:subClassOf	sumo:SportsTeam
RugbyClub	owl:equivalentClass	sumo:RugbyTeam
SoccerClub	owl:equivalentClass	sumo:SoccerTeam
NationalSoccerClub	owl:subClassOf	sumo:SoccerTeam
SportsLeague	owl:equivalentClass	sumo:SportsLeague
AmericanFootballLeague	owl:subClassOf	sumo:SportsLeague
AustralianFootballLeague	owl:subClassOf	sumo:SportsLeague
AutoRacingLeague	owl:subClassOf	sumo:SportsLeague
BaseballLeague	owl:subClassOf	sumo:SportsLeague
BasketballLeague	owl:subClassOf	sumo:SportsLeague
BowlingLeague	owl:subClassOf	sumo:SportsLeague
BoxingLeague	owl:subClassOf	sumo:SportsLeague
CanadianFootballLeague	owl:subClassOf	sumo:SportsLeague
CricketLeague	owl:subClassOf	sumo:SportsLeague
CurlingLeague	owl:subClassOf	sumo:SportsLeague
CyclingLeague	owl:subClassOf	sumo:SportsLeague
FieldHockeyLeague	owl:subClassOf	sumo:SportsLeague
FormulaOneRacing	owl:subClassOf	sumo:SportsLeague
GolfLeague	owl:subClassOf	sumo:SportsLeague
HandballLeague	owl:subClassOf	sumo:SportsLeague
IceHockeyLeague	owl:subClassOf	sumo:SportsLeague
InlineHockeyLeague	owl:subClassOf	sumo:SportsLeague
LacrosseLeague	owl:subClassOf	sumo:SportsLeague
MixedMartialArtsLeague	owl:subClassOf	sumo:SportsLeague
MotorcycleRacingLeague	owl:subClassOf	sumo:SportsLeague
PaintballLeague	owl:subClassOf	sumo:SportsLeague
PoloLeague	owl:subClassOf	sumo:SportsLeague
RadioControlledRacingLeague	owl:subClassOf	sumo:SportsLeague
RugbyLeague	owl:subClassOf	sumo:SportsLeague
SoccerLeague	owl:subClassOf	sumo:SportsLeague
SoftballLeague	owl:subClassOf	sumo:SportsLeague
SpeedwayLeague	owl:subClassOf	sumo:SportsLeague
TennisLeague	owl:subClassOf	sumo:SportsLeague
VideogamesLeague	owl:subClassOf	sumo:SportsLeague
VolleyballLeague	owl:subClassOf	sumo:SportsLeague
SportsTeam	owl:equivalentClass	sumo:SportsTeam
AmericanFootballTeam	owl:equivalentClass	sumo:FootballTeam
AustralianFootballTeam	owl:subClassOf	sumo:SportsTeam
BaseballTeam	owl:equivalentClass	sumo:BaseballTeam
BasketballTeam	owl:equivalentClass	sumo:BasketballTeam
CanadianFootballTeam	owl:subClassOf	sumo:FootballTeam
CricketTeam	owl:subClassOf	sumo:SportsTeam
CyclingTeam	owl:subClassOf	sumo:SportsTeam
FormulaOneTeam	owl:subClassOf	sumo:SportsTeam
HandballTeam	owl:subClassOf	sumo:SportsTeam
HockeyTeam	owl:subClassOf	sumo:SportsTeam
SpeedwayTeam	owl:subClassOf	sumo:SportsTeam
TermOfOffice	owl:subClassOf	sumo:Time
TradeUnion	owl:subClassOf	sumo:Organization
Person	owl:subClassOf	sumo:Human
Archeologist	owl:equivalentClass	sumo:Archeologist	# (note that all Occupations are instances of SocialRole)
Architect	owl:equivalentClass	sumo:Architect
Aristocrat	owl:subClassOf	sumo:SocialRole
Artist	owl:subClassOf	sumo:ArtisticOccupation
Actor	owl:equivalentClass	sumo:Actor
AdultActor	owl:subClassOf	sumo:Actor
VoiceActor	owl:equivalentClass	sumo:VoiceActor
Comedian	owl:equivalentClass	sumo:Comedian
ComicsCreator	owl:subClassOf	sumo:ArtisticOccupation
Dancer	owl:equivalentClass	sumo:Dancer
FashionDesigner	owl:subClassOf	sumo:Designer
Humorist	owl:subClassOf	sumo:Writer
MusicalArtist	owl:equivalentClass	sumo:Musician
BackScene	owl:subClassOf	sumo:ArtisticOccupation
ClassicalMusicArtist	owl:subClassOf	sumo:Musician
Instrumentalist	owl:subClassOf	sumo:Musician
Guitarist	owl:equivalentClass	sumo:Guitarist
MusicDirector	owl:subClassOf	sumo:ArtisticOccupation
Singer	owl:subClassOf	sumo:Musician
Painter	owl:equivalentClass	sumo:Painter
Photographer	owl:subClassOf	sumo:ArtisticOccupation
Sculptor	owl:equivalentClass	sumo:Sculptor
Astronaut	owl:equivalentClass	sumo:Astronaut
Athlete	owl:subClassOf	sumo:SportsPosition
ArcherPlayer	owl:subClassOf	sumo:SportsPosition
AthleticsPlayer	owl:subClassOf	sumo:SportsPosition
AustralianRulesFootballPlayer	owl:subClassOf	sumo:SportsPosition
BadmintonPlayer	owl:subClassOf	sumo:SportsPosition
BaseballPlayer	owl:equivalentClass	sumo:BaseballPlayer
BasketballPlayer	owl:equivalentClass	sumo:BasketballPlayer
Bodybuilder	owl:subClassOf	sumo:SportsPosition
Boxer	owl:equivalentClass	sumo:Boxer
AmateurBoxer	owl:subClassOf	sumo:SocialRole
BullFighter	owl:subClassOf	sumo:SportsPosition
Canoeist	owl:subClassOf	sumo:SportsPosition
ChessPlayer	owl:subClassOf	sumo:SocialRole
Cricketer	owl:equivalentClass	sumo:Cricketer
Cyclist	owl:equivalentClass	sumo:Cyclist
DartsPlayer	owl:subClassOf	sumo:SportsPosition
Fencer	owl:subClassOf	sumo:SportsPosition
GaelicGamesPlayer	owl:subClassOf	sumo:SportsPosition
GolfPlayer	owl:equivalentClass	sumo:Golfer
GridironFootballPlayer	owl:subClassOf	sumo:SportsPosition
AmericanFootballPlayer	owl:equivalentClass	sumo:FootballerUS
CanadianFootballPlayer	owl:subClassOf	sumo:SportsPosition
Gymnast	owl:equivalentClass	sumo:Gymnast
HandballPlayer	owl:subClassOf	sumo:SportsPosition
HighDiver	owl:subClassOf	sumo:SportsPosition
HorseRider	owl:subClassOf	sumo:SportsPosition
Jockey	owl:subClassOf	sumo:SportsPosition
LacrossePlayer	owl:equivalentClass	sumo:LacrossePlayer
MartialArtist	owl:subClassOf	sumo:SportsPosition
MotorsportRacer	owl:subClassOf	sumo:SportsPosition
MotorcycleRider	owl:equivalentClass	sumo:MotorcycleRider
MotocycleRacer	owl:subClassOf	sumo:MotorcycleRider
SpeedwayRider	owl:subClassOf	sumo:RacingCarDriver
RacingDriver	owl:equivalentClass	sumo:RacingCarDriver
DTMRacer	owl:subClassOf	sumo:RacingCarDriver
FormulaOneRacer	owl:subClassOf	sumo:RacingCarDriver
NascarDriver	owl:subClassOf	sumo:RacingCarDriver
RallyDriver	owl:subClassOf	sumo:RacingCarDriver
NationalCollegiateAthleticAssociationAthlete	owl:subClassOf	sumo:SportsPosition
NetballPlayer	owl:subClassOf	sumo:SportsPosition
PokerPlayer	owl:subClassOf	sumo:SocialRole
Rower	owl:subClassOf	sumo:SportsPosition
RugbyPlayer	owl:equivalentClass	sumo:RugbyPlayer
SnookerPlayer	owl:subClassOf	sumo:SportsPosition
SnookerChamp	owl:subClassOf	sumo:SportsPosition
SoccerPlayer	owl:equivalentClass	sumo:FootballerSoccer
SquashPlayer	owl:subClassOf	sumo:SportsPosition
Surfer	owl:subClassOf	sumo:SportsPosition
Swimmer	owl:equivalentClass	sumo:Swimmer
TableTennisPlayer	owl:subClassOf	sumo:SportsPosition
TeamMember	owl:subClassOf	sumo:SportsPosition
TennisPlayer	owl:equivalentClass	sumo:TennisProfessional
VolleyballPlayer	owl:subClassOf	sumo:SportsPosition
BeachVolleyballPlayer	owl:subClassOf	sumo:SportsPosition
WaterPoloPlayer	owl:subClassOf	sumo:SportsPosition
WinterSportPlayer	owl:subClassOf	sumo:SportsPosition
Biathlete	owl:subClassOf	sumo:SportsPosition
BobsleighAthlete	owl:subClassOf	sumo:SportsPosition
CrossCountrySkier	owl:subClassOf	sumo:SportsPosition
Curler	owl:subClassOf	sumo:SportsPosition
FigureSkater	owl:equivalentClass	sumo:FigureSkater
IceHockeyPlayer	owl:equivalentClass	sumo:IceHockeyPlayer
NordicCombined	owl:subClassOf	sumo:SportsPosition
Skater	owl:subClassOf	sumo:SportsPosition
Ski_jumper	owl:subClassOf	sumo:SportsPosition
Skier	owl:subClassOf	sumo:SportsPosition
SpeedSkater	owl:subClassOf	sumo:SportsPosition
Wrestler	owl:equivalentClass	sumo:Wrestler
SumoWrestler	owl:subClassOf	sumo:Wrestler
BeautyQueen	owl:subClassOf	sumo:SocialRole
BusinessPerson	owl:subClassOf	sumo:Wrestler
Celebrity	owl:subClassOf	sumo:Wrestler
Chef	owl:equivalentClass	sumo:Chef
Cleric	owl:equivalentClass	sumo:Cleric
Cardinal	owl:equivalentClass	sumo:Cardinal
ChristianBishop	owl:equivalentClass	sumo:Bishop
Archbishop	owl:subClassOf	sumo:Bishop
ChristianPatriarch	owl:subClassOf	sumo:ReligiousPosition
Pope	owl:equivalentClass	sumo:Pope
Priest	owl:subClassOf	sumo:Cleric
Saint	owl:subClassOf	sumo:ReligiousPosition
Vicar	owl:subClassOf	sumo:ReligiousPosition
Coach	owl:equivalentClass	sumo:Coach
AmericanFootballCoach	owl:subClassOf	sumo:Coach
CollegeCoach	owl:subClassOf	sumo:Coach
VolleyballCoach	owl:subClassOf	sumo:Coach
Criminal	owl:equivalentClass	sumo:Criminal
Murderer	owl:subClassOf	sumo:Criminal
SerialKiller	owl:subClassOf	sumo:Criminal
Economist	owl:subClassOf	sumo:Economist
Egyptologist	owl:subClassOf	sumo:Scientist
Engineer	owl:subClassOf	sumo:Scientist
Farmer	owl:subClassOf	sumo:OccupationalRole
HorseTrainer	owl:subClassOf	sumo:OccupationalRole
Journalist	owl:equivalentClass	sumo:Journalist
Judge	owl:equivalentClass	sumo:Judge
Lawyer	owl:equivalentClass	sumo:Lawyer
Linguist	owl:equivalentClass	sumo:Linguist
MemberResistanceMovement	owl:subClassOf	sumo:SocialRole
MilitaryPerson	owl:equivalentClass	sumo:MilitaryPerson
Model	owl:subClassOf	sumo:OccupationalRole
Monarch	owl:equivalentClass	sumo:Monarch
MovieDirector	owl:subClassOf	sumo:ArtisticOccupation
Noble	owl:subClassOf	sumo:SocialRole
OfficeHolder	owl:subClassOf	sumo:GovernmentPerson
OrganisationMember	owl:subClassOf	sumo:Position
SportsTeamMember	owl:subClassOf	sumo:SportsPosition
Philosopher	owl:equivalentClass	sumo:Philosopher
PlayboyPlaymate	owl:subClassOf	sumo:EntertainmentProfession
Politician	owl:subClassOf	sumo:GovernmentPerson
Ambassador	owl:subClassOf	sumo:Diplomat
Chancellor	owl:subClassOf	sumo:GovernmentPerson
Congressman	owl:subClassOf	sumo:GovernmentPerson
Deputy	owl:subClassOf	sumo:GovernmentPerson
Governor	owl:equivalentClass	sumo:Governor
Lieutenant	owl:subClassOf	sumo:GovernmentPerson
Mayor	owl:equivalentClass	sumo:Mayor
MemberOfParliament	owl:subClassOf	sumo:GovernmentPerson
Minister	owl:subClassOf	sumo:GovernmentPerson
President	owl:subClassOf	sumo:GovernmentPerson
PrimeMinister	owl:subClassOf	sumo:GovernmentPerson
Senator	owl:subClassOf	sumo:GovernmentPerson
VicePresident	owl:subClassOf	sumo:GovernmentPerson
VicePrimeMinister	owl:subClassOf	sumo:GovernmentPerson
PoliticianSpouse	owl:subClassOf	sumo:SocialRole
Presenter	owl:subClassOf	sumo:SkilledOccupation
RadioHost	owl:subClassOf	sumo:SkilledOccupation
TelevisionHost	owl:subClassOf	sumo:SkilledOccupation
Producer	owl:subClassOf	sumo:SkilledOccupation
Psychologist	owl:equivalentClass	sumo:Psychologist
Referee	owl:subClassOf	sumo:SocialRole
Religious	owl:subClassOf	sumo:SocialRole
RomanEmperor	owl:subClassOf	sumo:Leader
Royalty	owl:subClassOf	sumo:SocialRole
BritishRoyalty	owl:subClassOf	sumo:SocialRole
Baronet	owl:subClassOf	sumo:SocialRole
Scientist	owl:equivalentClass	sumo:Scientist
Biologist	owl:equivalentClass	sumo:Biologist
Entomologist	owl:subClassOf	sumo:Biologist
Medician	owl:subClassOf	sumo:Scientist
Professor	owl:subClassOf	sumo:Scientist
SportsManager	owl:equivalentClass	sumo:SportsManager
SoccerManager	owl:subClassOf	sumo:SportsManager
TelevisionDirector	owl:subClassOf	sumo:Manager
TheatreDirector	owl:subClassOf	sumo:Manager
Writer	owl:equivalentClass	sumo:Writer
Historian	owl:equivalentClass	sumo:Historian
MusicComposer	owl:equivalentClass	sumo:Composer
PlayWright	owl:subClassOf	sumo:Writer
Poet	owl:subClassOf	sumo:Writer
ScreenWriter	owl:subClassOf	sumo:Writer
SongWriter	owl:subClassOf	sumo:Composer
Altitude	owl:subClassOf	sumo:a Relation and not a Class
AnatomicalStructure	owl:equivalentClass	sumo:AnatomicalStructure
Artery	owl:equivalentClass	sumo:Artery
BloodVessel	owl:equivalentClass	sumo:BloodVessel
Bone	owl:equivalentClass	sumo:Bone
Brain	owl:equivalentClass	sumo:Brain
Embryology	sumo:Embryonic	# an Attribute and not a Class)
Ligament	owl:subClassOf	sumo:AnimalAnatomicalStructure
Lymph	owl:subClassOf	sumo:Gland
Muscle	owl:equivalentClass	sumo:Muscle
Nerve	owl:subClassOf	sumo:AnimalAnatomicalStructure
Vein	owl:equivalentClass	sumo:Vein
Area	owl:subClassOf	sumo:AreaMeasure	# (referring to a particular UnifOfMeasure)
Award	owl:subClassOf	sumo:Proposition
Decoration	owl:subClassOf	sumo:Proposition
NobelPrize	owl:subClassOf	sumo:Proposition
Biomolecule	owl:subClassOf	sumo:BiologicallyActiveSubstance
Enzyme	owl:equivalentClass	sumo:Enzyme
Gene	owl:subClassOf	sumo:DNAMolecule
HumanGene	owl:subClassOf	sumo:DNAMolecule
MouseGene	owl:subClassOf	sumo:DNAMolecule
Hormone	owl:equivalentClass	sumo:Hormone
Lipid	owl:subClassOf	sumo:BiologicallyActiveSubstance
Polysaccharide	owl:subClassOf	sumo:Carbohydrate
Protein	owl:equivalentClass	sumo:Protein
Blazon	owl:subClassOf	sumo:Icon
ChartsPlacements	owl:subClassOf	sumo:Icon
ChemicalSubstance	owl:subClassOf	sumo:Substance
ChemicalCompound	owl:equivalentClass	sumo:CompoundSubstance
ChemicalElement    	owl:subClassOf	sumo:ElementalSubstance
Drug	owl:equivalentClass	sumo:Medicine
CombinationDrug	owl:subClassOf	sumo:Medicine
MonoclonalAntibody	owl:subClassOf	sumo:Antibody
Vaccine	owl:subClassOf	sumo:Medicine
Mineral	owl:equivalentClass	sumo:Mineral
Colour	owl:equivalentClass	sumo:ColorAttribute
Currency	owl:equivalentClass	sumo:Currency
Demographics	owl:subClassOf	sumo:GroupOfPeople
Depth	owl:subClassOf	sumo:LengthMeasure	# (depth is a relationship)
Device	owl:equivalentClass	sumo:Device
Battery	owl:equivalentClass	sumo:Battery
Camera	owl:equivalentClass	sumo:Camera
DigitalCamera	owl:subClassOf	sumo:Camera
Engine	owl:equivalentClass	sumo:Engine
AutomobileEngine	owl:subClassOf	sumo:Engine
RocketEngine	owl:subClassOf	sumo:Camera
InformationAppliance	owl:subClassOf	sumo:Computer
Instrument	owl:equivalentClass	sumo:MusicalInstrument
Guitar	owl:equivalentClass	sumo:Guitar
Organ	owl:subClassOf	sumo:MusicalInstrument
MobilePhone	owl:subClassOf	sumo:MobileCellPhone
Weapon	owl:equivalentClass	sumo:Weapon
Diploma	owl:subClassOf	sumo:AcademicDegree
Disease	owl:equivalentClass	sumo:DiseaseOrSyndrome
ElectionDiagram	owl:subClassOf	sumo:Icon
ElectricalSubstation	owl:subClassOf	sumo:ElectricDevice
EthnicGroup	owl:equivalentClass	sumo:EthnicGroup
Event	owl:equivalentClass	sumo:Process
Competition	owl:equivalentClass	sumo:Contest
Contest	owl:subClassOf	sumo:Contest
LifeCycleEvent	owl:subClassOf	sumo:Process
PersonalEvent	owl:subClassOf	sumo:Process
Birth	owl:equivalentClass	sumo:Birth
Death	owl:equivalentClass	sumo:Death
Divorce	owl:equivalentClass	sumo:Divorcing
Marriage	owl:subClassOf	sumo:Declaring
NaturalEvent	owl:equivalentClass	sumo:NaturalProcess
Earthquake	owl:equivalentClass	sumo:Earthquake
SolarEclipse	owl:subClassOf	sumo:NaturalProcess
StormSurge	owl:subClassOf	sumo:WaterMotion
PenaltyShootOut	owl:subClassOf	sumo:GameShot
SocietalEvent	owl:equivalentClass	sumo:SocialInteraction
AcademicConference	owl:subClassOf	sumo:FormalMeeting
Attack	owl:subClassOf	sumo:ViolentContest
Convention	owl:subClassOf	sumo:FormalMeeting
Election	owl:equivalentClass	sumo:Election
FilmFestival	owl:subClassOf	sumo:Meeting
HistoricalEvent	owl:subClassOf	sumo:Process
Meeting	owl:equivalentClass	sumo:Meeting
MilitaryConflict	owl:subClassOf	sumo:Battle
MusicFestival	owl:subClassOf	sumo:Meeting
Rebellion	owl:subClassOf	sumo:ViolentContest
SpaceMission	owl:subClassOf	sumo:SpaceTransportation
SportsEvent	owl:equivalentClass	sumo:Sport
CyclingCompetition	owl:equivalentClass	sumo:Cycling
FootballMatch	owl:equivalentClass	sumo:Soccer
GrandPrix	owl:subClassOf	sumo:Racing
InternationalFootballLeagueEvent	owl:subClassOf	sumo:Soccer
MixedMartialArtsEvent	owl:equivalentClass	sumo:MartialArts
NationalFootballLeagueEvent	owl:subClassOf	sumo:Soccer
Olympics	owl:equivalentClass	sumo:OlympicGames
OlympicEvent	owl:subClassOf	sumo:OlympicGames
Race	owl:equivalentClass	sumo:Racing
CyclingRace	owl:equivalentClass	sumo:Cycling
HorseRace	owl:equivalentClass	sumo:HorseRacing
MotorRace	owl:subClassOf	sumo:Racing
Tournament	owl:subClassOf	sumo:Contest
GolfTournament	owl:equivalentClass	sumo:Golf
SoccerTournament	owl:equivalentClass	sumo:Soccer
TennisTournament	owl:equivalentClass	sumo:Tennis
WomensTennisAssociationTournament	owl:subClassOf	sumo:Tennis
WrestlingEvent	owl:subClassOf	sumo:MartialArts
Flag	owl:equivalentClass	sumo:Flag
Food	owl:equivalentClass	sumo:Food
Beverage	owl:equivalentClass	sumo:Beverage
Beer	owl:equivalentClass	sumo:Beer
Vodka	owl:equivalentClass	sumo:Vodka
Wine	owl:equivalentClass	sumo:Wine
ControlledDesignationOfOriginWine	owl:subClassOf	sumo:Wine
Cheese	owl:equivalentClass	sumo:Cheese
GeneLocation	owl:subClassOf	sumo:Region
HumanGeneLocation	owl:subClassOf	sumo:Region
MouseGeneLocation	owl:subClassOf	sumo:Region
GrossDomesticProduct	owl:subClassOf	sumo:FunctionQuantity
GrossDomesticProductPerCapita	owl:subClassOf	sumo:FunctionQuantity
Holiday	owl:equivalentClass	sumo:Holiday
HumanDevelopmentIndex	owl:subClassOf	sumo:RealNumber
Identifier	owl:equivalentClass	sumo:Identifier
TopLevelDomain	owl:subClassOf	sumo:IPAddress
Language	owl:equivalentClass	sumo:Language
ProgrammingLanguage	owl:equivalentClass	sumo:ComputerLanguage
List	owl:equivalentClass	sumo:List
TrackList	owl:subClassOf	sumo:List
MeanOfTransportation	owl:equivalentClass	sumo:TransportationDevice
Aircraft	owl:equivalentClass	sumo:Aircraft
MilitaryAircraft	owl:subClassOf	sumo:Aircraft
Automobile	owl:equivalentClass	sumo:Automobile
Locomotive	owl:equivalentClass	sumo:Locomotive
MilitaryVehicle	owl:equivalentClass	sumo:MilitaryVehicle
Motorcycle	owl:equivalentClass	sumo:Motorcycle
On-SiteTransportation	owl:subClassOf	sumo:TransportationDevice
ConveyorSystem	owl:subClassOf	sumo:TransportationDevice
Escalator	owl:subClassOf	sumo:TransportationDevice
MovingWalkway	owl:subClassOf	sumo:TransportationDevice
Rocket	owl:equivalentClass	sumo:Rocket
Ship	owl:equivalentClass	sumo:Ship
SpaceShuttle	owl:subClassOf	sumo:Spacecraft
SpaceStation	owl:subClassOf	sumo:Spacecraft
Spacecraft	owl:equivalentClass	sumo:Spacecraft
Train	owl:equivalentClass	sumo:Train
TrainCarriage	owl:subClassOf	sumo:RailVehicle
Tram	owl:subClassOf	sumo:TransportationDevice
Media	owl:subClassOf	sumo:DigitalData
MedicalSpecialty	owl:equivalentClass	sumo:MedicalScience
Medicine	owl:subClassOf	sumo:MedicalScience
Name	owl:equivalentClass	sumo:Name
GivenName	owl:subClassOf	sumo:Name
Surname	owl:subClassOf	sumo:Name
PersonFunction	owl:subClassOf	sumo:SocialRole
PoliticalFunction	owl:subClassOf	sumo:Position
Profession	owl:equivalentClass	sumo:Profession
Place	owl:subClassOf	sumo:Region
ArchitecturalStructure	owl:subClassOf	sumo:StationaryArtifact
AmusementParkAttraction	owl:subClassOf	sumo:RecreationOrExerciseDevice
RollerCoaster	owl:subClassOf	sumo:RecreationOrExerciseDevice
WaterRide	owl:subClassOf	sumo:RecreationOrExerciseDevice
Arena	owl:subClassOf	sumo:Building
Building	owl:equivalentClass	sumo:Building
Casino	owl:equivalentClass	sumo:Casino
Castle	owl:subClassOf	sumo:Building
Factory	owl:subClassOf	sumo:Building
HistoricBuilding	owl:subClassOf	sumo:Building
Hospital	owl:equivalentClass	sumo:HospitalBuilding
Hotel	owl:equivalentClass	sumo:HotelBuilding
Museum	owl:equivalentClass	sumo:Museum
Prison	owl:equivalentClass	sumo:Prison
ReligiousBuilding	owl:equivalentClass	sumo:ReligiousBuilding
Church	owl:equivalentClass	sumo:ChurchBuilding
Monastery	owl:subClassOf	sumo:ReligiousBuilding
Mosque	owl:equivalentClass	sumo:Mosque
Shrine	owl:subClassOf	sumo:ReligiousBuilding
Synagogue	owl:equivalentClass	sumo:Synagogue
Temple	owl:subClassOf	sumo:ReligiousBuilding
Restaurant	owl:equivalentClass	sumo:RestaurantBuilding
ShoppingMall	owl:equivalentClass	sumo:ShoppingMall
Skyscraper	owl:subClassOf	sumo:HighRise
Venue	owl:subClassOf	sumo:Building
Cinema	owl:subClassOf	sumo:Building
Stadium	owl:subClassOf	sumo:SportsFacility
Theatre	owl:subClassOf	sumo:Building
Infrastructure	owl:subClassOf	sumo:StationaryArtifact
Airport	owl:equivalentClass	sumo:Airport
Dam	owl:equivalentClass	sumo:Dam
Dike	owl:subClassOf	sumo:Dam
LaunchPad	owl:subClassOf	sumo:StationaryArtifact
Lock	owl:subClassOf	sumo:CanalLock
Port	owl:equivalentClass	sumo:PortFacility
PowerStation	owl:subClassOf	sumo:StationaryArtifact
NuclearPowerStation	owl:subClassOf	sumo:StationaryArtifact
ProductionPlant	owl:subClassOf	sumo:StationaryArtifact
RestArea	owl:subClassOf	sumo:StationaryArtifact
RouteOfTransportation	owl:subClassOf	sumo:Transitway
Bridge	owl:equivalentClass	sumo:Bridge
RailwayLine	owl:subClassOf	sumo:RailTransportationSystem
RailwayTunnel	owl:subClassOf	sumo:Tunnel
Road	owl:equivalentClass	sumo:Roadway
RoadJunction	owl:equivalentClass	sumo:RoadJunction
RoadTunnel	owl:subClassOf	sumo:Tunnel
WaterwayTunnel	owl:subClassOf	sumo:Tunnel
Station	owl:equivalentClass	sumo:TransitTerminal
MetroStation	owl:subClassOf	sumo:RailwayTerminal
RailwayStation	owl:subClassOf	sumo:RailwayTerminal
RouteStop	owl:subClassOf	sumo:TransitTerminal
TramStation	owl:subClassOf	sumo:RailwayTerminal
MilitaryStructure	owl:subClassOf	sumo:StationaryArtifact
Fort	owl:subClassOf	sumo:StationaryArtifact
Mill	owl:subClassOf	sumo:StationaryArtifact
Treadmill	owl:subClassOf	sumo:Device
Watermill	owl:subClassOf	sumo:StationaryArtifact
WindMotor	owl:subClassOf	sumo:Windmill
Windmill	owl:equivalentClass	sumo:Windmill
Monument	owl:equivalentClass	sumo:Monument
GraveMonument	owl:subClassOf	sumo:Monument
Memorial	owl:subClassOf	sumo:Monument
Pyramid	owl:subClassOf	sumo:StationaryArtifact
SportFacility	owl:equivalentClass	sumo:SportsFacility
CricketGround	owl:subClassOf	sumo:SportsFacility
GolfCourse	owl:equivalentClass	sumo:GolfCourse
RaceTrack	owl:subClassOf	sumo:SportsFacility
Racecourse	owl:subClassOf	sumo:SportsFacility
SkiArea	owl:equivalentClass	sumo:SkiingFacility
SkiResort	owl:subClassOf	sumo:SkiingFacility
Square	owl:subClassOf	sumo:StationaryArtifact
Tower	owl:subClassOf	sumo:StationaryArtifact
Lighthouse	owl:subClassOf	sumo:StationaryArtifact
WaterTower	owl:subClassOf	sumo:FluidContainer
Tunnel	owl:equivalentClass	sumo:Tunnel
Zoo	owl:subClassOf	sumo:AnimalResidence
CelestialBody	owl:equivalentClass	sumo:AstronomicalBody
Asteroid	owl:subClassOf	sumo:AstronomicalBody
Constellation	owl:subClassOf	sumo:AstronomicalBody
Galaxy	owl:subClassOf	sumo:AstronomicalBody
Planet	owl:equivalentClass	sumo:Planet
Satellite	owl:equivalentClass	sumo:Satellite
ArtificialSatellite	owl:equivalentClass	sumo:ArtificialSatellite
Star	owl:equivalentClass	sumo:Star
BrownDwarf	owl:subClassOf	sumo:Star
Swarm	owl:subClassOf	sumo:AstronomicalBody
Globularswarm	owl:subClassOf	sumo:AstronomicalBody
Openswarm	owl:subClassOf	sumo:AstronomicalBody
Cemetery	owl:equivalentClass	sumo:Cemetery
ConcentrationCamp	owl:subClassOf	sumo:Prison
CountrySeat	owl:subClassOf	sumo:LandArea
Garden	owl:equivalentClass	sumo:CultivatedLandArea
HistoricPlace	owl:subClassOf	sumo:StationaryArtifact
Mine	owl:equivalentClass	sumo:Mine
CoalPit	owl:subClassOf	sumo:Mine
NaturalPlace	owl:subClassOf	sumo:Region
Archipelago	owl:equivalentClass	sumo:Archipelago
Beach	owl:subClassOf	sumo:ShoreArea
BodyOfWater	owl:equivalentClass	sumo:BodyOfWater
Bay	owl:equivalentClass	sumo:Bay
Lake	owl:equivalentClass	sumo:Lake
Ocean	owl:equivalentClass	sumo:Ocean
Sea	owl:equivalentClass	sumo:Sea
Stream	owl:equivalentClass	sumo:StreamWaterArea
Canal	owl:equivalentClass	sumo:Canal
Creek	owl:equivalentClass	sumo:Creek
River	owl:equivalentClass	sumo:River
Cape	owl:equivalentClass	sumo:Cape
Cave	owl:equivalentClass	sumo:Cave
Crater	owl:subClassOf	sumo:Hole
LunarCrater	owl:subClassOf	sumo:Hole
Desert	owl:equivalentClass	sumo:Desert
Forest	owl:equivalentClass	sumo:Forest
Glacie	owl:equivalentClassr	sumo:Glacier
HotSpring	owl:subClassOf	sumo:WaterArea
Mountain	owl:equivalentClass	sumo:Mountain
MountainPass	owl:subClassOf	sumo:MountainousTerrain
MountainRange	owl:equivalentClass	sumo:MountainRange
Valley	owl:equivalentClass	sumo:Valley
Volcano	owl:equivalentClass	sumo:Volcano
Park	owl:equivalentClass	sumo:Park
PopulatedPlace	owl:subClassOf	sumo:GeographicRegion
Agglomeration	owl:subClassOf	sumo:GeographicRegion
Community	owl:subClassOf	sumo:GeographicRegion
Continent	owl:equivalentClass	sumo:Continent
Country	owl:equivalentClass	sumo:Nation
HistoricalCountry	owl:subClassOf	sumo:Nation
GatedCommunity	owl:subClassOf	sumo:GeographicRegion
Intercommunality	owl:subClassOf	sumo:GeographicRegion
Island	owl:equivalentClass	sumo:Island
Atoll	owl:equivalentClass	sumo:Atoll
Locality	owl:equivalentClass	sumo:GeographicRegion
Region	owl:subClassOf	sumo:GeographicRegion
AdministrativeRegion	owl:subClassOf	sumo:GeopoliticalArea
ClericalAdministrativeRegion	owl:subClassOf	sumo:GeopoliticalArea
Deanery	owl:subClassOf	sumo:GeopoliticalArea
Diocese	owl:subClassOf	sumo:GeopoliticalArea
Parish	owl:subClassOf	sumo:GeopoliticalArea
GovernmentalAdministrativeRegion	owl:subClassOf	sumo:GeopoliticalArea
Arrondissement	owl:subClassOf	sumo:GeopoliticalArea
Canton	owl:subClassOf	sumo:GeopoliticalArea
Department	owl:subClassOf	sumo:GeopoliticalArea
OverseasDepartment	owl:subClassOf	sumo:GeopoliticalArea
District	owl:equivalentClass	sumo:CityDistrict
HistoricalDistrict	owl:subClassOf	sumo:CityDistrict
DistrictWaterBoard	owl:subClassOf	sumo:GeopoliticalArea
MicroRegion	owl:subClassOf	sumo:GeopoliticalArea
Municipality	owl:subClassOf	sumo:GeopoliticalArea
FormerMunicipality	owl:subClassOf	sumo:GeopoliticalArea
Prefecture	owl:subClassOf	sumo:GeopoliticalArea
Province	owl:equivalentClass	sumo:StateOrProvince
HistoricalProvince	owl:subClassOf	sumo:StateOrProvince
Regency	owl:subClassOf	sumo:GeopoliticalArea
SubMunicipality	owl:subClassOf	sumo:GeopoliticalArea
HistoricalAreaOfAuthority	owl:subClassOf	sumo:GeopoliticalArea
Fiefdom	owl:subClassOf	sumo:GeopoliticalArea
HistoricalRegion	owl:subClassOf	sumo:GeopoliticalArea
NaturalRegion	owl:subClassOf	sumo:GeographicRegion
Settlement	owl:subClassOf	sumo:GeographicRegion
City	owl:equivalentClass	sumo:City
Capital	owl:subClassOf	sumo:City
CapitalOfRegion	owl:subClassOf	sumo:City
CityDistrict	owl:subClassOf	sumo:CityDistrict
HistoricalSettlement	owl:subClassOf	sumo:GeographicRegion
Town	owl:subClassOf	sumo:City
Village	owl:subClassOf	sumo:City
State	owl:equivalentClass	sumo:StateOrProvince
Street	owl:equivalentClass	sumo:Street
Territory	owl:subClassOf	sumo:GeopoliticalArea
OldTerritory	owl:subClassOf	sumo:GeopoliticalArea
ProtectedArea	owl:subClassOf	sumo:GeographicRegion
SiteOfSpecialScientificInterest	owl:subClassOf	sumo:GeographicRegion
WineRegion	owl:subClassOf	sumo:CultivatedLandArea
WorldHeritageSite	owl:subClassOf	sumo:GeographicRegion
Population	owl:equivalentClass	sumo:GroupOfPeople
PublicService	owl:subClassOf	sumo:SocialInteraction
Relationship	owl:subClassOf	sumo:Relation
Ratio	owl:subClassOf	sumo:PerFn
Species	owl:subClassOf	sumo:Organism
Archaea	owl:subClassOf	sumo:Organism
Bacteria	owl:equivalentClass	sumo:Bacterium
Eukaryote	owl:equivalentClass	sumo:EukaryoticCell
Animal	owl:equivalentClass	sumo:Animal
Amphibian	owl:equivalentClass	sumo:Amphibian
Arachnid	owl:equivalentClass	sumo:Arachnid
Bird	owl:equivalentClass	sumo:Bird
Crustacean	owl:equivalentClass	sumo:Crustacean
Fish	owl:equivalentClass	sumo:Fish
Insect	owl:equivalentClass	sumo:Insect
Mammal	owl:equivalentClass	sumo:Mammal
Cat	owl:equivalentClass	sumo:DomesticCat
Dog	owl:equivalentClass	sumo:DomesticDog
Horse	owl:equivalentClass	sumo:Horse
Mollusca	owl:equivalentClass	sumo:Mollusk
Reptile	owl:equivalentClass	sumo:Reptile
Fungus	owl:equivalentClass	sumo:Fungus
Plant	owl:equivalentClass	sumo:Plant
ClubMoss	owl:subClassOf	sumo:Moss
Conifer	owl:subClassOf	sumo:BotanicalTree
CultivatedVariety	owl:subClassOf	sumo:Plant
Cycad	owl:subClassOf	sumo:Plant
Fern	owl:equivalentClass	sumo:Fern
FloweringPlant	owl:equivalentClass	sumo:FloweringPlant
Grape	owl:subClassOf	sumo:FloweringPlant
Ginkgo	owl:subClassOf	sumo:Gnetophytes
Gnetophytes	owl:subClassOf	sumo:Gnetophytes
GreenAlga	owl:subClassOf	sumo:Alga
Moss	owl:equivalentClass	sumo:Moss
SportCompetitionResult	owl:subClassOf	sumo:ConstantQuantity
OlympicResult	owl:subClassOf	sumo:ConstantQuantity
SnookerWorldRanking	owl:subClassOf	sumo:ConstantQuantity
SportsSeason	owl:subClassOf	sumo:TimeInterval
MotorsportSeason	owl:subClassOf	sumo:TimeInterval
SportsTeamSeason	owl:subClassOf	sumo:TimeInterval
BaseballSeason	owl:subClassOf	sumo:TimeInterval
FootballLeagueSeason	owl:subClassOf	sumo:TimeInterval
NationalFootballLeagueSeason	owl:subClassOf	sumo:TimeInterval
NCAATeamSeason	owl:subClassOf	sumo:TimeInterval
SoccerClubSeason	owl:subClassOf	sumo:TimeInterval
SoccerLeagueSeason	owl:subClassOf	sumo:TimeInterval
Statistic	owl:subClassOf	sumo:PhysicalQuantity
TimePeriod	owl:equivalentClass	sumo:TimeInterval
CareerStation	owl:subClassOf	sumo:TimeInterval
MilitaryService	owl:subClassOf	sumo:TimeInterval
GeologicalPeriod	owl:subClassOf	sumo:TimeInterval
HistoricalPeriod	owl:subClassOf	sumo:TimeInterval
PeriodOfArtisticStyle	owl:subClassOf	sumo:TimeInterval
PrehistoricalPeriod	owl:subClassOf	sumo:TimeInterval
ProtohistoricalPeriod	owl:subClassOf	sumo:TimeInterval
Reign	owl:subClassOf	sumo:TimeInterval
Tenure	owl:subClassOf	sumo:TimeInterval
Year	owl:equivalentClass	sumo:Year
YearInSpaceflight	owl:subClassOf	sumo:Year
TopicalConcept	owl:equivalentClass	sumo:FieldOfStudy
AcademicSubject	owl:subClassOf	sumo:FieldOfStudy
CardinalDirection	owl:subClassOf	sumo:DirectionalAttribute
Fashion	owl:subClassOf	sumo:FieldOfStudy
Genre	owl:subClassOf	sumo:RelationalAttribute
ArtisticGenre	owl:subClassOf	sumo:RelationalAttribute
LiteraryGenre	owl:subClassOf	sumo:RelationalAttribute
MovieGenre	owl:subClassOf	sumo:RelationalAttribute
MusicGenre	owl:equivalentClass	sumo:MusicGenre
Ideology	owl:subClassOf	sumo:Proposition
MathematicalConcept	owl:subClassOf	sumo:Proposition
PhilosophicalConcept	owl:subClassOf	sumo:Proposition
PoliticalConcept	owl:subClassOf	sumo:Proposition
ScientificConcept	owl:subClassOf	sumo:Proposition
Standard	owl:subClassOf	sumo:Proposition
SystemOfLaw	owl:subClassOf	sumo:LegalSystemAttribute
Tax	owl:subClassOf	sumo:LegalSystemAttribute
Taxon	owl:subClassOf	sumo:Organism
TheologicalConcept	owl:subClassOf	sumo:Proposition
ChristianDoctrine	owl:subClassOf	sumo:Proposition
Type	owl:equivalentClass	sumo:Class
DocumentType	owl:subClassOf	sumo:RelationalAttribute
GovernmentType	owl:subClassOf	sumo:FormOfGovernment
UnitOfWork	owl:subClassOf	sumo:Process
Case	owl:subClassOf	sumo:OrganizationalProcess
LegalCase	owl:subClassOf	sumo:LegalAction
SupremeCourtOfTheUnitedStatesCase 	owl:subClassOf	sumo:LegalAction
Project	owl:subClassOf	sumo:Process
ResearchProject	owl:subClassOf	sumo:Investigating
Unknown	owl:subClassOf	sumo:Entity
WikimediaTemplate	owl:subClassOf	sumo:Entity
Work	owl:equivalentClass	sumo:ContentBearingPhysical
Artwork	owl:equivalentClass	sumo:ArtWork
Painting	owl:equivalentClass	sumo:PaintedPicture
Sculpture	owl:equivalentClass	sumo:Sculpture
Cartoon	owl:subClassOf	sumo:ArtWork
Anime	owl:subClassOf	sumo:MotionPicture
HollywoodCartoon	owl:subClassOf	sumo:MotionPicture
CollectionOfValuables	owl:subClassOf	sumo:Collection
Archive	owl:subClassOf	sumo:Document
Database	owl:subClassOf	sumo:Database
BiologicalDatabase	owl:subClassOf	sumo:Database
Document	owl:equivalentClass	sumo:Document
File	owl:equivalentClass	sumo:ComputerFile
Image	owl:subClassOf	sumo:Icon
MovingImage	owl:equivalentClass	sumo:MotionPicture
StillImage	owl:subClassOf	sumo:Icon
Sound	owl:subClassOf	sumo:AudioFile
Film	owl:subClassOf	sumo:MotionPicture
LineOfFashion	owl:subClassOf	sumo:WearableItem
MusicalWork	owl:equivalentClass	sumo:Music
Album	owl:equivalentClass	sumo:Album
ArtistDiscography	owl:subClassOf	sumo:MotionPicture
ClassicalMusicComposition	owl:subClassOf	sumo:MotionPicture
Musical	owl:subClassOf	sumo:Song
NationalAnthem	owl:subClassOf	sumo:Song
Opera	owl:subClassOf	sumo:Opera
Single	owl:subClassOf	sumo:Song
Song	owl:equivalentClass	sumo:Song
EurovisionSongContestEntry	owl:subClassOf	sumo:Song
RadioProgram	owl:equivalentClass	sumo:RadioBroadcasting
Software	owl:equivalentClass	sumo:Software
VideoGame	owl:equivalentClass	sumo:VideoGame
TelevisionEpisode	owl:subClassOf	sumo:TelevisionBroadcasting
TelevisionSeason	owl:subClassOf	sumo:TelevisionBroadcasting
TelevisionShow	owl:subClassOf	sumo:TelevisionBroadcasting
Website	owl:equivalentClass	sumo:Website
WrittenWork	owl:subClassOf	sumo:Text
Annotation	owl:subClassOf	sumo:Text
Reference	owl:subClassOf	sumo:Text
Article	owl:equivalentClass	sumo:Article
Book	owl:equivalentClass	sumo:Book
Novel	owl:equivalentClass	sumo:Novel
LightNovel	owl:equivalentClass	sumo:Novel
Comic	owl:subClassOf	sumo:Text
ComicStrip	owl:subClassOf	sumo:Text
Manga	owl:subClassOf	sumo:Text
Manhua	owl:subClassOf	sumo:Text
Manhwa	owl:subClassOf	sumo:Text
Drama	owl:subClassOf	sumo:DramaticPlay
Law	owl:equivalentClass	sumo:Law
Letter	owl:equivalentClass	sumo:Character
MultiVolumePublication	owl:subClassOf	sumo:Series
PeriodicalLiterature	owl:equivalentClass	sumo:Periodical
AcademicJournal	owl:subClassOf	sumo:Periodical
Magazine	owl:subClassOf	sumo:Magazine
Newspaper	owl:subClassOf	sumo:Newspaper
UndergroundJournal	owl:subClassOf	sumo:Periodical
Play	owl:equivalentClass	sumo:DramaticPlay
Poem	owl:subClassOf	sumo:Text
Quote	owl:subClassOf	sumo:Text
Resume	owl:subClassOf	sumo:FactualText
StatedResolution	owl:subClassOf	sumo:Report
Treaty	owl:equivalentClass	sumo:Treaty
foaf:Document	owl:equivalentClass	sumo:Text
cidoccrm:E4_Period	owl:equivalentClass	sumo:TimeInterval
d0:Activity	owl:equivalentClass	sumo:Process
foaf:Image	owl:equivalentClass	sumo:Image
foaf:Person	owl:equivalentClass	sumo:Human
geo:SpatialThing	owl:equivalentClass	sumo:Object
gml:_Feature	owl:equivalentClass	sumo:Attribute
rdf:Property	owl:equivalentClass	sumo:Attribute
skos:Concept	owl:equivalentClass	sumo:Class
skos:OrderedCollection	owl:equivalentClass	sumo:List
